11111111111111111111111111
10010000000C00000000000001
10000011110000000000000001
1P00001E010000000000000001
10000010010000000001110001
11111110010000000001110001
10000000000000000000000001
10000000000000000000000001
10011100000000000000000001
10011100000001111100000001
10000000000001111100000001
10000000000001111100000001
1000000000000000C000000001
10000111110000000000000001
100001C0010000000000000001
10000100010000000000000001
10000100010000000000000001
10000000000000000000000001
11111111111111111111111111