1111111111111111111111111111111111111111111111111111111111111111111111111111111111111111111111111111111111111111111111111
1P00000001000000000000000000001001000001000000000001000000000001000000001001001001001000000000000000000000000001000000001
1001111100000000001111111111001001111001001001001001111001001111111111001001001001001001111001111001001111111111111111001
1000001000000000000001001000001000001000001001001000000001001001000000001000001000001001000001000001000001000001001000001
1001111000000111111110011111110011110010011111110011111111110010011111111110011110011110010011110011110010010010010010001
1000001001000000000000001000000000000001001001000001000000001000000001000000000000000000001001000000001000001000001001001
1001001001111111111111001111001111111001001001111001001001111111001111001111001111111001111111001001001111001001111111001
1001001000000000001000000000000001000001000000001000001001000001001000001000001000000000001000001001001001001001001000001
1001111001111111111111001111111111111001111001111111111111111001001111111111111111001111111111111111001001001111001111001
10000010000000000000010010000000010C0001001000001001001001001000000000001001000000001000000000001001001001001000000000001
1001001001111111111001111001111111111001001111001001001001001111001001111001001111001111001001001001111001111001111001001
1001000000000001001000000000001001000001000000000000001000001000001000001000001000001000001001001000000001000001000001001
1001111001111111001111111001111001001001111001001111001001001001111001111111001111001001111111111111111001111001001001111
1001000000000001000000000001001001001001000001000001000001000001001000001000001000000001000000000001000000001001001000001
1111111111001001111001111001001001001111001111001111111111001001001111111111111001111001001001001111001111001001111001111
1000000001001000001001001000001000000001000001001000000000001000000000001001000000001001001001000000001000001001000001001
1001111111111001001001001001001111111111001111111111111111001001001001111001111001001001001001001111001001001001111111001
1000000001000001001001000001001001001000000001000000000000001001001001000000001001001000001001001001001001000000000000001
1001111111001111001001111111001001001111001001111001001111001111111111111001111111111111111001001001111111001111001001111
1000000001001000001000001000000000001001001001001001001000000001000001001000001000001000000001000001000000001000001000001
1001001001001111001111111111001111001001111001001111001111111001111001001001111111001001111111111111111001001111111001111
1001001000001000001001000000001001000001000000000001001000000001000000000000000000000001000001000000000001000001001000001
1111001001111111001001111001001001111111111111111111001111001111001111111001111001001001111001111001111001001111001111111
10000010000010010010000010010000010010010000010010010C1001001000001001000000001001001001001001000001001001000000000000001
1111111111111001001001111111001001001001001111001001001001001001111001111111111111001001001001111001001111111001111111111
1000000000000001001001001001001001000001001000000001001000001001001000000000001000001001000000001001000000000001001000001
1001111001111001111001001001111001001001001001001001111001001001001111001001001111111111111001111111001111111001001111001
1001000000001000001000000000000000001001000001001001000001000000001001001001000001000C00001000000000001000001001001001001
1001111001111111111111001001001111001001001111111001111111111001111001001001001111111001111111001001111001001001001001001
1001000001001000000000001001000001001001000001001000000000000000001000001001001000001000001000001000001001001000000001001
1001111001001111001001111111111001111111001111001001111001111001111001001111001001001001111111111001111001001111111001001
1001000000001001001000000001000000001000000001000000001001000000001001001000000001001000000001000001001001000001001001001
1111001111001001001111111111001111111111001001111111001001001111001111001001111111001111001111111001001111001111001111001
1001000001000001000000000001001000000001001000001000001001001000001000001000000C01001000000001001000000001000001000000001
1001001111111111111001001111001111001001111111001111001111111111111001111001001001001111111001001001111001001111001001001
1000000000001000001001000001001001001000001001000001001000001000000000001001001001001000000001000000001000000000001001001
1111001111001001111001111111111001111001111001001E01001111001001001001111001111111111111111001111111001111001111111111001
1000001000001000000001000001000000001001000001001001001000001001001001000000000000000001000000000001000001001000000000001
1111001111111001111001111001111111001001001001001111001111001001001111111111001111001111111001111111001111111111001111001
1001001000000000001000000001000000000001001000000001000000001001001000000001000001000001000000001000000000000001000001001
1001001111111001111111001001111111111001001111001111111111001111111001001111111001111111001111001001001111111001001111001
1000000000000001000001001000001000001001001000000001000001000000000001000000000000001000001000000001000001000001001001001
1111111111111001001001001111111111001001001111001111001111111001001111111111111111001111111001111111001111111111111001001
1000000000001001001001001001000001000000001000000000001000001001000001000000000000001000000001000001000001001001001000001
1111001111001001001111001001001111111111111001111111111111001001111111001111111111001111111001111001001001001001001001111
1001001000000000001001000000001000000001001000000000001000000001000001000001000001000001000000000001001000001000001001001
1001111001111001111001111111001001111111001111111001111001111001001001001001001111001111111001111111001111001111001111001
1000000000001000001001001001001000001001001000001000001000001001001001001000000001000001001000001001001000000001000001001
1111111001111111111001001001001001111CC1001001111111111111001111001111111001111111001111001111111001001111111001001111001
1000000001001000000001001000000001000000001000000000001000000000001001000000001000000001000001000000001001000000000000001
1111001111001111111001001111001001111001111001111111111111111001111001111111001111001111001111111001111001001111111001111
1000001000001000001000001001001000001000000001000000001000001001001000000000001000001001000000001000000001000001000001001
1001111111001111001111001001111001001111111001111001001111001111001111001111001111111001001111111111111111111001111001001
1000000000001001000001000001001001000000000001001001001000000000001001001001000000000000001000001000001000001001000000001
1111111001111001111001001111001111001001111111001001111111001111111001001001001111111111111111001111001001111001111111111
1001000000000001000000000001001001001000001001000001001000000001000001000001001000000000000001000001000001000001000001001
1001111111001111001111111001001001001111001001111001001111001001001111001111001111111111001111001001111001001111111001001
1000001000001001001000000000000001000001000000000000001001001000000001000001001000000000001000001001001000000001000001001
1111001001111001111111001001111001001111111001111111001001001001111001111001111111111001001111111001001111001001001111001
1000001000000001000000001001000000000000001001001000000000001001001000000000000001000001000001000000001000001000000000001
1111001111111111111001111001111001111111111111001111001001001001001001111111111001111111001001111001111111111001001111111
1000001000001000000001000000001000001000000001000001001001001001000001000001000001000000001001000000000000001001000001001
1001111001111111001111001111111111001001111111111001111001001111111111111001001111001001111001001111111111111001111111001
1001000001001001001000001000000001000000000000001001001001001000000000001001000000001000001000000000000001000001000001001
1001001001001001111111111001111111111001001111001001001001111001001001111001001111111111001111111001111111111001001111001
1000001000001000000000000000000001000001001001000001000000001001001001000000000001001000001000001001000001001000000001001
1111001001001111111111111111001001001111111001111111001111111001001111001111111001001111001001111111001111001001111111001
1000001001000001000000000000001000001000001000001001001000000001001001000001000000001000001000000000000001001000000001001
1111111001001111111111111001111111001001111111001001001111111001111001001001001111001111111111001001001001001111001111001
1000001001000000001000001001000000001000000000000001000000000000000001001001000001000000000000001001001001000000000000001
1001001001001001001111001111111111001111001001111001001111111001111111111111001111001111111111001111111111001111111111001
1001001001001001001001000000000000001001001001000001000001000000000001000001001001001001001000001000001000001001000001001
1111001111001001001001111111111111001001001111111001111111111001111001001001001001111001001001001001001111001001111001001
1000000000001001000000000001001000C00000001000000000000000001000001001001001001000001001000001001001001000000001001000001
1111111001111111001111001001001111111111001001111111001111001111111001001111111001111001001001111001111001001001001111001
1001000000000001001001001001000000000000001001001000001000001000001000001000001000000000001001000001000001001001000000001
1001001111001001001001111111001001001111001001001111111001111111001111001111001111111111111001111001111001111111111001111
1000001000001001001000000001001001000001001000000000001000001001001001001000000000001000001000000000001000001000000000001
1001001111111001111111001111001001001111001001111001111111001001001001001001111001111001111001001111111111001111111001001
1001000000001000000000000000001001001000001000001000001000000000001000000000001000001000000001001000000000000000001001001
1111111111111111111111111111111111111111111111111111111111111111111111111111111111111111111111111111111111111111111111111