111111111111111111111
10010000000C000000001
100001111100000000001
1P0011E00000000000001
100011C00000000000001
11111100C000000000001
10000000000E000C00001
100000000000000000001
1000000C0000000000001
100000000000C00000001
100000000000000000001
100000C000000000C0001
111111111111111111111